10.oX
o.o......o
.oo...oo..
o........o
..o...oo..
.o.......o
.....oo..o
.....o.o..
.......o..
....o.....
....o.....